############################################################################
#                 #         #                              #               #
######### ######### ######### ############################## ###############
#         #                   #                                            #
# ###################### ################################################# #
#                     #                                              #     #
############## ##################################################### # #####
#                                   #                                #     #
################################### ############################## ####### #
#                                                                          #
##################  ########################### ################### ########
#       #                     ssccsss                                      #
#       #     #               ccssssc                               #      #
######## ######### ##### ########### ################# #####################
#              #                 #            #                            #
######### ############### ##################################### ############
#              #                 #            #                            #
#             #      ################## ################################## #
############# #  ##  ################   ################################   #
#                   ######## #######  ################################## ###
######  ########### ######## ####### ##################################  ###
#       ########### ######## ####### ##################################  ###
#  ################ ######## ######  ###################################  ##
# ################# ######## ###### ##################################### ##
#                                                                          #
#                                                                          #
########################################################################## #
#                                                                          #
# ##########################################################################
#                                                                          #
########################################################################## #
#                                                                          #
#E##########################################################################