############################################################################
#                                                                          #
###### ######## ####### ######## ######## ######## ####### ######## ###### #
###### ######## ####### ######## ######## ######## ####### ######## ###### #
#                       ########                                           #
###### ######## ####### ######## ######## ######## ####### ######## ###### #
###### ######## ####### ######## ######## ######## ####### ######## ###### #
#                                                  #######                 #
###### ######## ####### ######## ######## ######## ####### ######## ###### #
###### ######## ####### ######## ######## ######## ####### ######## ###### #
#      ########                                                            #
###### ######## ####### ######## ######## ######## ####### ######## ###### #
###### ######## ####### ######## ######## ######## ####### ######## ###### #
#                                                                          #
###### ######## ####### ######## ######## ######## ####### ######## ###### #
###### ######## ####### ######## ######## ######## ####### ######## ###### #
#                                                                          #
###### ######## ####### ######## ######## ######## ####### ######## ###### #
###### ######## ####### ######## ######## ######## ####### ######## ###### #
#                                ########                                  #
###### ######## ####### ######## ######## ######## ####### ######## ###### #
###### ######## ####### ######## ######## ######## ####### ######## ###### #
#                                                                          #
###### ######## ####### ######## ######## ######## ####### ######## ###### #
###### ######## ####### ######## ######## ######## ####### ######## ###### #
E      ########                                                            #
###### ######## ####### ######## ######## ######## ####### ######## ###### #
###### ######## ####### ######## ######## ######## ####### ######## ###### #
#                                                                          #
###### ######## ####### ######## ######## ######## ####### ######## ###### #
###### ######## ####### ######## ######## ######## ####### ######## ###### #
#                                                                          #
############################################################################