############################################################################
#             #      ################## ################################## #
############# #  ##  ################   ################################   #
#                   ######## #######  ################################## ###
######  ########### ######## #######                                     ###
#       ########### ######## ####### ##################################  ###
#  ################ ######## ######  ###################################  ##
# ################# ######## ###### ##################################### ##
#                                                                          #
##################  ########################### ################### ########
#       #                      s                                           #
#       #     #                                                     #      #
######## ######### ##### ########### ################# #####################
#              #                 #            #                            #
######### ############### ##################################### ############
#              #                 #            #                            #
#             #      ####### ########## ################################## #
############# #  ##  ####### ########   ################################   #
#                   ######## #######  ################################## ###
######  ########### ######## ####### ##################################  ###
#       ########### ######## ####### ##################################  ###
#  ################ ######## ######  ###################################  ##
E ################# ######## ###### ##################################### ##
#             #      ####### ######     #################################  #
############# #  ##  ####### ########   ################################   #
#                   ######## #######  ################################## ###
######  ########### ######## ####### ##################################  ###
#       ########### ######## ####### ##################################  ###
#  ################ ######## ######  ###################################  ##
# ################# ######## ###### #############                         ##
############################################################################