############################################################################
#                                                                          #
###### ######## ####### ######## ######## ######## ####### ######## ###### #
###### ######## ####### ######## ######## ######## ####### ######## ###### #
#                       ########                   ccccssss                #
###### ######## ####### ######## ######## ######## ####### ######## ###### #
###### ######## ####### ######## ######## ######## ####### ######## ###### #
#                                                  #######                 #
###### ######## ####### ######## ######## ######## ####### ######## ###### #
###### ######## ####### ######## ######## ######## ####### ######## ###### #
#      ########                                                            #
###### ######## ####### ######## ######## ######## ####### ######## ###### #
###### ######## ####### ######## ######## ######## ####### ######## ###### #
#                                                                          #
###### ######## ####### ######## ######## ######## ####### ######## ###### #
###### ######## ####### ######## ######## ######## ####### ######## ###### #
#                                                                          #
###### ######## ####### ######## ######## ######## ####### ######## ###### #
###### ######## ####### ######## ######## ######## ####### ######## ###### #
#                                E#######                                  #
###### ######## ####### ######## ######## ######## ####### ######## ###### #
###### ######## ####### ######## ######## ######## ####### ######## ###### #
#                                                                          #
###### ######## ####### ######## ######## ######## ####### ######## ###### #
###### ######## ####### ######## ######## ######## ####### ######## ###### #
#      ########                                                            #
###### ######## ####### ######## ######## ######## ####### ######## ###### #
###### ######## ####### ######## ######## ######## ####### ######## ###### #
#                                                                          #
###### ######## ####### ######## ######## ######## ####### ######## ###### #
###### ######## ####### ######## ######## ######## ####### ######## ###### #
#                                                                          #
############################################################################